{
  "name": "Opening",
  "caption": "This is really going to be something.",
  "map": [
    "NIL","NIL","NIL","NIL","NIL","NIL","NIL","NIL","NIL","NIL","NIL","NIL","NIL","NIL","NIL","NIL","NIL","NIL","NIL","NIL","NIL","NIL","NIL","NIL","NIL","D01","D01","NIL","NIL",
    "W40","W40","W40","W40","W40","W40","W40","W40","W40","W40","W40","W40","W40","W40","W40","W40","W40","W40","W40","W40","W40","W40","W40","W40","W40","F00","W45","W40","W40",
    "W40","W40","W40","W40","W40","W40","W40","W40","W40","W40","W40","W40","W40","W40","W40","W40","W40","W40","W40","W40","W40","W40","W40","W40","W40","F00","W45","W40","W40",
    "W40","W40","W40","W40","W40","W40","W40","W41","W40","W40","W40","W41","W40","W40","W40","W41","W40","W40","W40","W41","W40","W40","W40","W40","W40","F00","W45","W40","W40",
    "W40","W40","W43","W41","W41","W41","W41","F00","W41","W41","W41","F00","W41","W41","W41","F00","W41","W41","W41","F00","W41","W41","W41","W41","W41","F00","W45","W40","W40",
    "W40","W40","W44","F00","F00","F00","F00","F00","F00","F00","F00","F00","F00","F00","F00","F00","F00","F00","F00","F00","F00","F00","F00","F00","F00","F00","W45","W40","W40",
    "W40","W40","W44","F00","W40","W40","W40","F00","W40","W40","W40","F00","W40","W40","W40","F00","W40","W40","W40","F00","W40","W40","W40","W40","W40","W40","W40","W40","W40",
    "W40","W40","W44","F00","W40","W40","W40","W40","W40","W40","W40","W40","W40","W40","W40","W40","W40","W40","W40","W40","W40","W40","W40","W40","W40","W40","W40","W40","W40",
    "W40","W40","W44","F00","W40","W40","W40","W40","W40","W40","W40","W40","W40","W40","W40","W40","W40","W40","W40","W40","W40","W40","W40","W40","W40","W40","W40","W40","W40",
    "W40","W40","W44","F00","W40","W40","W40","W40","W40","W40","W40","W40","W40","W40","W40","W40","W40","W40","W40","W40","W40","W40","W40","W40","W40","W40","W40","W40","W40",
    "W40","W40","W44","F00","W40","W40","W40","W41","W40","W40","W40","W41","W40","W40","W40","W41","W40","W40","W40","W41","W40","W40","W40","W41","W40","W40","W40","W40","W40",
    "W40","W40","W44","F00","W41","W41","W41","F00","W41","W41","W41","F00","W41","W41","W41","F00","W41","W41","W41","F00","W41","W41","W41","F00","W41","W41","W42","W40","W40",
    "W40","W40","W47","W46","W46","W46","W46","F00","W46","W46","W46","F00","W46","W46","W46","F00","W46","W46","W46","F00","W46","W46","W46","F00","W46","F00","W45","W40","W40",
    "W40","W40","W40","W40","W40","W40","W40","W46","W40","W40","W40","W46","W40","W40","W40","W46","W40","W40","W40","W46","W40","W40","W40","W46","W40","F00","W45","W40","W40",
    "W40","W40","W40","W40","W40","W40","W40","W40","W40","W40","W40","W40","W40","W40","W40","W40","W40","W40","W40","W40","W40","W40","W40","W40","W40","F00","W45","W40","W40",
    "W40","W40","W40","W40","W40","W40","W40","W40","W40","W40","W40","W40","W40","W40","W40","W40","W40","W40","W40","W40","W40","W40","W40","W40","W40","F00","W45","W40","W40",
    "W40","W40","W40","W40","W40","W40","W40","W40","W40","W40","W40","W40","W40","W40","W40","W40","W40","W40","W40","W40","W40","W40","W40","W40","W40","F00","W45","W40","W40",
    "W40","W40","W40","W41","W40","W40","W40","W41","W40","W40","W40","W41","W40","W40","W40","W41","W40","W40","W40","W41","W40","W40","W40","W41","W40","F00","W45","W40","W40",
    "W40","W40","W43","F00","W41","W41","W41","F00","W41","W41","W41","F00","W41","W41","W41","F00","W41","W41","W41","F00","W41","W41","W41","F00","W41","F00","W45","W40","W40",
    "W40","W40","W47","F00","W46","W46","W46","F00","W46","W46","W46","F00","W46","W46","W46","F00","W46","W46","W46","F00","W46","W46","W46","F00","W46","W46","W48","W40","W40",
    "W40","W40","W40","W46","W40","W40","W40","W46","W40","W40","W40","W46","W40","W40","W40","W46","W40","W40","W40","W46","W40","W40","W40","W46","W40","W40","W40","W40","W40",
    "W40","W40","W40","W40","W40","W40","W40","W40","W40","W40","W40","W40","W40","W40","W40","W40","W40","W40","W40","W40","W40","W40","W40","W40","W40","W40","W40","W40","W40"
  ],
  "occupied_tiles": [],
  "cols": 29,
  "rows": 21,
  "tile_diameter": 320,
  "start_position": {
    "x": 26,
    "y": 2
  },
  "start_direction": "up",
  "items": [

  ],
  "npcs": [

  ]
}
